../Images/sprite_sheet.png
1,1 1,1 1,1 1,1 1,1 1,1 1,1 1,1 1,1 1,1 1,1
1,1 x,x x,x 2,0 1,1 2,0 x,x 3,0 2,0 3,1 1,1
1,1 x,x 2,0 2,0 x,x 2,0 1,1 x,x 1,1 2,0 1,1
1,1 1,1 0,0 2,0 1,1 2,0 x,x 0,2 2,0 x,x 1,1
1,1 2,0 x,x 2,0 x,x x,x 1,1 3,0 1,1 2,0 1,1
1,1 x,x 1,1 x,x 1,1 1,2 x,x x,x 2,0 x,x 1,1
1,1 1,1 x,x x,x x,x 0,1 1,1 x,x 1,1 x,x 1,1
1,1 1,2 2,0 2,0 1,1 2,0 2,0 x,x 2,0 2,0 1,1
1,1 2,0 1,1 2,0 x,x 2,0 1,1 2,0 1,1 x,x 1,1
1,1 2,0 1,1 x,x 1,1 2,0 x,x x,x 2,0 2,0 1,1
1,1 x,x 2,0 3,0 x,x 0,2 2,0 0,0 x,x 3,0 1,1
1,1 1,1 1,1 1,1 1,1 1,1 1,1 1,1 1,1 1,1 1,1